5 11
11111111111
10000000001
11111111011
10000010011
10111010111
10001000101
11101111101
10001000101
10111010101
10000010001
11111111101

11111111111
10000000101
11101110101
10000010001
10111010111
10001010001
11111011101
10001010001
10101010111
10100010001
11111111101

11111111111
10100000001
10101111101
10001000101
10111110001
00100010101
11101010101
10001000101
10111111101
10000000001
11111111111

11111111111
10000100101
11101110101
10001000001
11101010111
10001010001
00111011101
10100010001
10101010111
10001010001
11111111111

11111111101
10000000001
11111110111
10000010001
10101011101
10101010001
10101010101
10001000011
10111111001
10000000001
11111111111